1111111
1000001
1011101
1C1P1E1
1011101
1000001
1111111
