11111111
1P000001
10111101
101C1101
10111101
1000E001
11111111
