1111111111
1P00000001
1000111001
1C00100C01
1000100001
1000E00001
1111111111
