1111111
1P0C001
1111101
1E00001
1111111
