1111111111111111111111111
1000000000000000000000001
1000000000111111000000001
1000111100000000111100001
100010000000C000000100001
1000100001110110000100001
1000100001000010000100001
1000100001000010000100001
100010000100E010000100001
1000100001111110000100001
10000000P00000C0000000001
1000111111110111111110001
1000000000000000000000001
1000000000000000000000001
1111111111111111111111111
