11111111111111111111
1P000000000000000001
10111111111111111101
10C00000000000000C01
10111111111111111101
10000000000000000001
10111111111111111101
10C00000000000000C01
10111111111111111101
1000000000000000C001
10111111111111111101
10000000000000000E01
11111111111111111111
